#1
100
61 73 148 166 182 29 57 153 48 52 179 97 202 39 25 107 177 144 192 86 84 177 84 124 58 197 201 30 131 37 174 182 27 72 154 49 140 69 56 174 41 55 26 73 36 141 25 29 29 77 83 45 183 101 204 151 41 113 38 90 150 91 47 72 52 138 199 135 85 130 31 164 202 144 138 40 76 79 133 40 177 190 172 90 178 162 199 24 182 186 45 183 152 189 145 119 52 178 201 145
Output: 
61 
73 148 
29 57 166 182 
25 39 48 52 97 153 179 202 
30 37 58 84 84 86 107 124 131 144 174 177 177 192 197 201 
25 26 27 29 29 36 38 41 41 45 47 49 55 56 69 72 73 77 83 90 91 101 113 140 141 150 151 154 174 182 183 204 
24 31 40 40 45 52 52 72 76 79 85 90 119 130 133 135 138 138 144 145 145 152 162 164 172 177 178 178 182 183 186 189 190 199 199 201 202

#2
24
71 128 30 154 194 31 170 159 110 124 152 67 182 53 191 201 125 24 170 155 179 198 118 181
Output:
71 
30 128 
31 154 170 194 
53 67 110 124 152 159 182 191 
24 118 125 155 170 179 181 198 201

#3
12
191 35 19 31 11 195 40 177 181 86 146 125
Output: 
191 
19 35 
11 31 40 195 
86 125 146 177 181

#4
25
2 7 9 16 15 1 4 18 4 9 7 22 17 16 2 18 20 13 12 11 9 5 24 20 24
Output: 
2 
7 9 
1 4 15 16 
2 4 7 9 16 17 18 22 
5 9 11 12 13 18 20 20 24 24 
